F 0,0,0
C 0,0,0

SO ./textures/1.xpm
NO ./textures/e.xpm
WE ./textures/2.xpm
EA ./textures/e.xpm

11111111 111111111111111
11111  111       111
10111101E111011101
101010100100101001
101010000101000101
110000001010000001
11111111111111111
