F 0,0,0
C 0,0,0

SO ./textures/1.xpm
NO ./textures/2.xpm
WE ./textures/e.xpm
EA ./textures/1.xpm

11111111 111111111111111
11111  111       111
10111101N111011101
101010100100101001
101010000101000101
110000001010000001
11111111111111111
